{
    "width": 10,
    "height": 10,
    "tiles": [
        { "row": [1, 1, 1, 0, 1, 1, 1, 1, 1, 1] },
        { "row": [1, 1, 1, 0, 1, 1, 1, 1, 1, 1] },
        { "row": [1, 1, 1, 0, 1, 1, 1, 0, 1, 1] },
        { "row": [1, 1, 1, 0, 1, 1, 1, 1, 1, 1] },
        { "row": [1, 1, 1, 0, 1, 1, 1, 1, 0, 1] },
        { "row": [1, 1, 1, 0, 1, 1, 1, 1, 1, 1] },
        { "row": [1, 1, 1, 0, 1, 1, 1, 1, 1, 1] },
        { "row": [1, 1, 1, 0, 0, 1, 0, 1, 1, 1] },
        { "row": [1, 1, 1, 0, 1, 1, 1, 1, 1, 1] },
        { "row": [1, 1, 1, 0, 1, 1, 1, 1, 1, 1] },
        { "row": [1, 1, 1, 0, 1, 1, 1, 1, 1, 1] }
    ],
    "startTileX": 0,
    "startTileY": 0,
    "endTileX": 9,
    "endTileY": 9
}