{
    "width": 12,
    "height": 12,
    "tiles": [
        { "row": [1, 1, 0, 0, 0, 0, 0, 0, 0, 0, 0, 0] },
        { "row": [0, 1, 0, 0, 0, 0, 0, 0, 0, 0, 0, 0] },
        { "row": [0, 1, 1, 1, 0, 0, 0, 0, 0, 0, 0, 0] },
        { "row": [0, 0, 0, 1, 0, 0, 0, 0, 0, 0, 0, 0] },
        { "row": [1, 1, 1, 1, 1, 1, 1, 1, 1, 1, 0, 0] },
        { "row": [1, 1, 1, 1, 1, 1, 1, 1, 1, 1, 1, 0] },
        { "row": [0, 0, 0, 0, 1, 0, 0, 0, 0, 0, 1, 0] },
        { "row": [0, 0, 0, 0, 1, 1, 1, 1, 0, 0, 1, 0] },
        { "row": [0, 0, 0, 0, 0, 0, 0, 1, 0, 0, 1, 0] },
        { "row": [0, 0, 0, 0, 0, 0, 0, 1, 1, 1, 1, 1] },
        { "row": [0, 0, 0, 0, 0, 0, 0, 0, 0, 0, 0, 1] },
        { "row": [0, 0, 0, 0, 0, 0, 0, 0, 0, 0, 0, 1] }
    ],
    "startTileX": 0,
    "startTileY": 0,
    "endTileX": 11,
    "endTileY": 11,
    "enemies": [
        { "startX": 4, "startY": 0, "endX": 4, "endY": 11 },
        { "startX": 5, "startY": 0, "endX": 5, "endY": 11 },
        { "startX": 10, "startY": 4, "endX": 10, "endY": 11 }
    ]
}
