{
    "width": 14,
    "height": 14,
    "tiles": [
        { "row": [1, 1, 0, 0, 0, 0, 0, 0, 0, 0, 0, 0, 0, 0] },
        { "row": [0, 1, 0, 0, 0, 0, 0, 0, 0, 0, 0, 0, 0, 0] },
        { "row": [0, 1, 1, 1, 0, 0, 0, 0, 0, 0, 0, 0, 0, 0] },
        { "row": [0, 0, 0, 1, 0, 0, 0, 0, 0, 0, 0, 0, 0, 0] },
        { "row": [1, 1, 1, 1, 1, 1, 1, 1, 1, 1, 1, 1, 1, 1] },
        { "row": [1, 1, 1, 1, 1, 1, 1, 1, 1, 1, 1, 1, 1, 1] },
        { "row": [1, 1, 1, 1, 1, 1, 1, 1, 1, 1, 1, 1, 1, 1] },
        { "row": [0, 0, 0, 0, 0, 1, 0, 0, 0, 0, 1, 1, 1, 1] },
        { "row": [0, 0, 0, 0, 0, 1, 1, 1, 1, 1, 0, 0, 1, 0] },
        { "row": [0, 0, 0, 0, 0, 0, 0, 0, 0, 1, 0, 0, 1, 0] },
        { "row": [0, 0, 0, 0, 0, 0, 0, 0, 0, 1, 1, 1, 1, 1] },
        { "row": [0, 0, 0, 0, 0, 0, 0, 0, 0, 0, 0, 0, 0, 1] },
        { "row": [0, 0, 0, 0, 0, 0, 0, 0, 0, 0, 0, 0, 0, 1] },
        { "row": [0, 0, 0, 0, 0, 0, 0, 0, 0, 0, 0, 0, 0, 1] }
    ],
    "startTileX": 0,
    "startTileY": 0,
    "endTileX": 13,
    "endTileY": 13,
    "enemies": [
        { "startX": 4, "startY": 0, "endX": 6, "endY": 13 },
        { "startX": 5, "startY": 0, "endX": 6, "endY": 13 },
        { "startX": 6, "startY": 0, "endX": 6, "endY": 13 }
    ]
}
