{
    "width": 26,
    "height": 26,
    "tiles": [
        { "row": [1,1,0,0,0,0,0,0,0,0,0,0,0,0,0,0,0,0,0,0,0,0,0,0,0,0] },
        { "row": [0,1,0,0,0,0,0,0,0,0,0,0,0,0,0,0,0,0,0,0,0,0,0,0,0,0] },
        { "row": [0,1,1,1,0,0,0,0,0,0,0,0,0,0,0,0,0,0,0,0,0,0,0,0,0,0] },
        { "row": [0,0,0,1,0,0,0,0,0,0,0,0,0,0,0,0,0,0,0,0,0,0,0,0,0,0] },
        { "row": [1,1,1,1,1,1,1,1,1,1,0,0,0,0,0,0,0,0,0,0,0,0,0,0,0,0] },
        { "row": [1,1,1,1,1,1,1,1,1,1,1,0,0,0,0,0,0,0,0,0,0,0,0,0,0,0] },
        { "row": [0,0,0,0,1,0,0,0,0,0,1,0,0,0,0,0,0,0,0,0,0,0,0,0,0,0] },
        { "row": [0,0,0,0,1,1,1,1,0,0,1,0,0,0,0,0,0,0,0,0,0,0,0,0,0,0] },
        { "row": [0,0,0,0,0,0,0,1,0,0,1,0,0,0,0,0,0,0,0,0,0,0,0,0,0,0] },
        { "row": [0,0,0,0,0,0,0,1,1,1,1,1,0,0,0,0,0,0,0,0,0,0,0,0,0,0] },
        { "row": [0,0,0,0,0,0,0,0,0,0,0,1,0,0,0,0,0,0,0,0,0,0,0,0,0,0] },
        { "row": [0,0,0,0,0,0,0,0,0,0,0,1,1,1,0,0,0,0,0,0,0,0,0,0,0,0] },
        { "row": [0,0,0,0,0,0,0,0,0,0,0,0,0,1,0,0,0,0,0,0,0,0,0,0,0,0] },
        { "row": [0,0,0,0,0,0,0,0,0,0,0,0,0,1,1,1,0,0,0,0,0,0,0,0,0,0] },
        { "row": [0,0,0,0,0,0,0,0,0,0,0,0,0,0,0,1,0,0,0,0,0,0,0,0,0,0] },
        { "row": [0,0,0,0,0,0,0,0,0,0,0,0,0,0,0,1,1,1,0,0,0,0,0,0,0,0] },
        { "row": [0,0,0,0,0,0,0,0,0,0,0,0,0,0,0,0,0,1,0,0,0,0,0,0,0,0] },
        { "row": [0,0,0,0,0,0,0,0,0,0,0,0,0,0,0,0,0,1,1,1,0,0,0,0,0,0] },
        { "row": [0,0,0,0,0,0,0,0,0,0,0,0,0,0,0,0,0,0,0,1,0,0,0,0,0,0] },
        { "row": [0,0,0,0,0,0,0,0,0,0,0,0,0,0,0,0,0,0,0,1,1,1,0,0,0,0] },
        { "row": [0,0,0,0,0,0,0,0,0,0,0,0,0,0,0,0,0,0,0,0,0,1,0,0,0,0] },
        { "row": [0,0,0,0,0,0,0,0,0,0,0,0,0,0,0,0,0,0,0,0,0,1,1,1,0,0] },
        { "row": [0,0,0,0,0,0,0,0,0,0,0,0,0,0,0,0,0,0,0,0,0,0,0,1,0,0] },
        { "row": [0,0,0,0,0,0,0,0,0,0,0,0,0,0,0,0,0,0,0,0,0,0,0,1,1,1] },
        { "row": [0,0,0,0,0,0,0,0,0,0,0,0,0,0,0,0,0,0,0,0,0,0,0,0,0,1] },
        { "row": [0,0,0,0,0,0,0,0,0,0,0,0,0,0,0,0,0,0,0,0,0,0,0,0,0,1] }
    ],
    "startTileX": 0,
    "startTileY": 0,
    "endTileX": 25,
    "endTileY": 25,
    "enemies": [
        { "startX": 4, "startY": 0, "endX": 4, "endY": 25 },
        { "startX": 5, "startY": 0, "endX": 5, "endY": 25 },
        { "startX": 10, "startY": 4, "endX": 10, "endY": 25 },
        { "startX": 11, "startY": 10, "endX": 11, "endY": 25 },
        { "startX": 13, "startY": 12, "endX": 13, "endY": 25 },
        { "startX": 15, "startY": 14, "endX": 15, "endY": 25 },
        { "startX": 17, "startY": 16, "endX": 17, "endY": 25 },
        { "startX": 19, "startY": 18, "endX": 19, "endY": 25 },
        { "startX": 21, "startY": 20, "endX": 21, "endY": 25 },
        { "startX": 23, "startY": 22, "endX": 23, "endY": 25 }
    ]
}
