{
    "width": 24,
    "height": 24,
    "tiles": [
        { "row": [1,1,0,0,0,0,0,0,0,0,0,0,0,0,0,0,0,0,0,0,0,0,0,0] },
        { "row": [0,1,0,0,0,0,0,0,0,0,0,0,0,0,0,0,0,0,0,0,0,0,0,0] },
        { "row": [0,1,1,1,0,0,0,0,0,0,0,0,0,0,0,0,0,0,0,0,0,0,0,0] },
        { "row": [0,0,0,1,0,0,0,0,0,0,0,0,0,0,0,0,0,0,0,0,0,0,0,0] },
        { "row": [1,1,1,1,1,1,1,1,1,1,0,0,0,0,0,0,0,0,0,0,0,0,0,0] },
        { "row": [1,1,1,1,1,1,1,1,1,1,1,0,0,0,0,0,0,0,0,0,0,0,0,0] },
        { "row": [0,0,0,0,1,0,0,0,0,0,1,0,0,0,0,0,0,0,0,0,0,0,0,0] },
        { "row": [0,0,0,0,1,1,1,1,0,0,1,0,0,0,0,0,0,0,0,0,0,0,0,0] },
        { "row": [0,0,0,0,0,0,0,1,0,0,1,0,0,0,0,0,0,0,0,0,0,0,0,0] },
        { "row": [0,0,0,0,0,0,0,1,1,1,1,1,0,0,0,0,0,0,0,0,0,0,0,0] },
        { "row": [0,0,0,0,0,0,0,0,0,0,0,1,0,0,0,0,0,0,0,0,0,0,0,0] },
        { "row": [0,0,0,0,0,0,0,0,0,0,0,1,1,1,0,0,0,0,0,0,0,0,0,0] },
        { "row": [0,0,0,0,0,0,0,0,0,0,0,0,0,1,0,0,0,0,0,0,0,0,0,0] },
        { "row": [0,0,0,0,0,0,0,0,0,0,0,0,0,1,1,1,0,0,0,0,0,0,0,0] },
        { "row": [0,0,0,0,0,0,0,0,0,0,0,0,0,0,0,1,0,0,0,0,0,0,0,0] },
        { "row": [0,0,0,0,0,0,0,0,0,0,0,0,0,0,0,1,1,1,0,0,0,0,0,0] },
        { "row": [0,0,0,0,0,0,0,0,0,0,0,0,0,0,0,0,0,1,0,0,0,0,0,0] },
        { "row": [0,0,0,0,0,0,0,0,0,0,0,0,0,0,0,0,0,1,1,1,0,0,0,0] },
        { "row": [0,0,0,0,0,0,0,0,0,0,0,0,0,0,0,0,0,0,0,1,0,0,0,0] },
        { "row": [0,0,0,0,0,0,0,0,0,0,0,0,0,0,0,0,0,0,0,1,1,1,0,0] },
        { "row": [0,0,0,0,0,0,0,0,0,0,0,0,0,0,0,0,0,0,0,0,0,1,0,0] },
        { "row": [0,0,0,0,0,0,0,0,0,0,0,0,0,0,0,0,0,0,0,0,0,1,1,1] },
        { "row": [0,0,0,0,0,0,0,0,0,0,0,0,0,0,0,0,0,0,0,0,0,0,0,1] },
        { "row": [0,0,0,0,0,0,0,0,0,0,0,0,0,0,0,0,0,0,0,0,0,0,0,1] }
    ],
    "startTileX": 0,
    "startTileY": 0,
    "endTileX": 23,
    "endTileY": 23,
    "enemies": [
        { "startX": 4, "startY": 0, "endX": 4, "endY": 23 },
        { "startX": 5, "startY": 0, "endX": 5, "endY": 23 },
        { "startX": 10, "startY": 4, "endX": 10, "endY": 23 },
        { "startX": 11, "startY": 10, "endX": 11, "endY": 23 },
        { "startX": 13, "startY": 12, "endX": 13, "endY": 23 },
        { "startX": 15, "startY": 14, "endX": 15, "endY": 23 },
        { "startX": 17, "startY": 16, "endX": 17, "endY": 23 },
        { "startX": 19, "startY": 18, "endX": 19, "endY": 23 },
        { "startX": 21, "startY": 20, "endX": 21, "endY": 23 }
    ]
}
