{
    "width": 16,
    "height": 16,
    "tiles": [
        { "row": [1, 1, 0, 0, 0, 0, 0, 0, 0, 0, 0, 0, 0, 0, 0, 0] },
        { "row": [0, 1, 0, 0, 0, 0, 0, 0, 0, 0, 0, 0, 0, 0, 0, 0] },
        { "row": [0, 1, 1, 1, 0, 0, 0, 0, 0, 0, 0, 0, 0, 0, 0, 0] },
        { "row": [0, 0, 0, 1, 0, 0, 0, 0, 0, 0, 0, 0, 0, 0, 0, 0] },
        { "row": [1, 1, 1, 1, 1, 1, 1, 1, 1, 1, 0, 0, 0, 0, 0, 0] },
        { "row": [1, 1, 1, 1, 1, 1, 1, 1, 1, 1, 1, 0, 0, 0, 0, 0] },
        { "row": [0, 0, 0, 0, 1, 0, 0, 0, 0, 0, 1, 0, 0, 0, 0, 0] },
        { "row": [0, 0, 0, 0, 1, 1, 1, 1, 0, 0, 1, 0, 0, 0, 0, 0] },
        { "row": [0, 0, 0, 0, 0, 0, 0, 1, 0, 0, 1, 0, 0, 0, 0, 0] },
        { "row": [0, 0, 0, 0, 0, 0, 0, 1, 1, 1, 1, 1, 0, 0, 0, 0] },
        { "row": [0, 0, 0, 0, 0, 0, 0, 0, 0, 0, 0, 1, 0, 0, 0, 0] },
        { "row": [0, 0, 0, 0, 0, 0, 0, 0, 0, 0, 0, 1, 1, 1, 0, 0] },
        { "row": [0, 0, 0, 0, 0, 0, 0, 0, 0, 0, 0, 0, 0, 1, 0, 0] },
        { "row": [0, 0, 0, 0, 0, 0, 0, 0, 0, 0, 0, 0, 0, 1, 1, 1] },
        { "row": [0, 0, 0, 0, 0, 0, 0, 0, 0, 0, 0, 0, 0, 0, 0, 1] },
        { "row": [0, 0, 0, 0, 0, 0, 0, 0, 0, 0, 0, 0, 0, 0, 0, 1] }
    ],
    "startTileX": 0,
    "startTileY": 0,
    "endTileX": 15,
    "endTileY": 15,
    "enemies": [
        { "startX": 4, "startY": 0, "endX": 4, "endY": 15 },
        { "startX": 5, "startY": 0, "endX": 5, "endY": 15 },
        { "startX": 10, "startY": 4, "endX": 10, "endY": 15 },
        { "startX": 11, "startY": 10, "endX": 11, "endY": 15 },
        { "startX": 13, "startY": 12, "endX": 13, "endY": 15 }
    ]
}
